une gazinière               - um fogão a gás
un frigidaire               - uma geladeira
un lave-linge               - uma máquina de lavar
un canapé                   - sofá
un canapé-lit               - um sofá-cama
un clic-clac                - um sofá-cama
une pendule                 - um relógio
un tapis                    - um tapete
un garage                   - uma garagem
une clé                     - uma chave
une poubel                  - uma lixeira
une lampe                   - luminária
un fauteuil                 - poltrona
table de basse              - mesa de café
la fenêtre                  - a janela
obturateur                  - veneziana
rideau                      - cortina
le plafond                  - teto
un lustre                   - um lustre
des bibelots                - pequenas decoraçōes
un tabouret                 - cadeira sem encosto
un table en bois            - mesa de madeira
un vase avec des fleurs     - um vaso de flores

---------------------------------------------------------------------------

je décrirai ma table de travail:
sur la table:
Il y a une lampe à gauche
Il y a un support de moniteur en métal au centre
Il y a une imprimante à droite
Il y a aussi un ordinateur, un clavier sans fil et une souris sans fil
Il y a des prises sous la table
Il y a une table près de la table
Il y a une fenêtre à côté de la table
Il y a un miroir loin de la table
Il y a une chaise en face de la table
La table est contre le mur e la table est blanche
